t1
XXXXXXXXX
X@      X
X.X$X X X
X       X
X X$X X X
X .     X
X X X X X
X*      X
XXXXXXXXX